Transaction Date,Transaction Remarks,Withdrawal Amount (INR),Deposit Amount (INR),Balance (INR)
01/09/2024,TRANSFER FROM JOHN DOE,,20000,32000
04/09/2024,ELECTRICITY BILL PAYMENT,3250,,28750
05/09/2024,SUPERMARKET XYZ,1200,,27550
08/09/2024,MOBILE RECHARGE,499,,27051
12/09/2024,TRANSFER TO JANE SMITH,10000,,17051
15/09/2024,CASH DEPOSIT,,5000,22051