Date,Narration,Debit,Credit,Closing Balance
01/09/2024,SALARY SEPTEMBER,,"50,000.00",75000.50
02/09/2024,RENT PAYMENT,15000.00,,60000.50
03/09/2024,GROCERY STORE PURCHASE,2500.50,,57500.00
05/09/2024,ONLINE SHOPPING,7800.00,,49700.00
07/09/2024,ATM WITHDRAWAL,5000.00,,44700.00
10/09/2024,INTEREST CREDITED,,"250.75",44950.75